BOARD:
==========================================
[0, 0, 0, 0, 0, 0, 0, 0, 0, 0, 0, 0, 0, 0]
[0, 0, 0, 0, 0, 0, 0, 0, 0, 0, 0, 0, 0, 0]
[0, 0, 1, 1, 1, 0, 0, 0, 0, 0, 0, 0, 0, 0]
[0, 0, 1, 1, 1, 1, 1, 1, 0, 0, 0, 0, 0, 0]
[0, 0, 1, 1, 1, 1, 1, 1, 1, 1, 1, 0, 0, 0]
[0, 0, 0, 1, 1, 1, 1, 1, 1, 1, 1, 1, 0, 0]
[0, 0, 0, 0, 0, 0, 0, 1, 1, 2, 1, 1, 0, 0]
[0, 0, 0, 0, 0, 0, 0, 0, 1, 1, 1, 0, 0, 0]
[0, 0, 0, 0, 0, 0, 0, 0, 0, 0, 0, 0, 0, 0]
[0, 0, 0, 0, 0, 0, 0, 0, 0, 0, 0, 0, 0, 0]
==========================================
- START: (3, 3), (3, 3)
- RIGHT: (3, 4), (3, 5)
- DOWN: (4, 4), (4, 5)
- DOWN: (5, 4), (5, 5)
- RIGHT: (5, 6), (5, 6)
- RIGHT: (5, 7), (5, 8)
- DOWN: (6, 7), (6, 8)
- RIGHT: (6, 9), (6, 9)
--> GOAL: (6, 9), (6, 9)
Time: 0.0229 s
Memory: 30.08 MB