BOARD:
=========================================================
[0, 0, 0, 0, 0, 0, 0, 0, 0, 0, 0, 0, 0, 0, 0, 0, 0, 0, 0]
[0, 0, 0, 0, 0, 0, 0, 0, 0, 0, 0, 0, 0, 0, 0, 0, 0, 0, 0]
[0, 0, 0, 0, 0, 0, 0, 0, 0, 0, 0, 1, 1, 1, 0, 0, 0, 0, 0]
[0, 0, 0, 0, 0, 0, 0, 0, 0, 0, 0, 1, 1, 1, 0, 0, 0, 0, 0]
[0, 0, 0, 0, 0, 0, 0, 0, 0, 0, 0, 1, 1, 1, 0, 0, 0, 0, 0]
[0, 0, 1, 1, 1, 1, 1, 1, 0, 0, 0, 1, 1, 1, 1, 1, 1, 0, 0]
[0, 0, 1, 1, 1, 1, 8, 1, 0, 0, 0, 1, 1, 1, 1, 2, 1, 0, 0]
[0, 0, 1, 1, 1, 1, 1, 1, 0, 0, 0, 1, 1, 1, 1, 1, 1, 0, 0]
[0, 0, 0, 0, 0, 0, 0, 0, 0, 0, 0, 1, 1, 1, 0, 0, 0, 0, 0]
[0, 0, 0, 0, 0, 0, 0, 0, 0, 0, 0, 1, 1, 1, 0, 0, 0, 0, 0]
[0, 0, 0, 0, 0, 0, 0, 0, 0, 0, 0, 1, 1, 1, 0, 0, 0, 0, 0]
[0, 0, 0, 0, 0, 0, 0, 0, 0, 0, 0, 0, 0, 0, 0, 0, 0, 0, 0]
[0, 0, 0, 0, 0, 0, 0, 0, 0, 0, 0, 0, 0, 0, 0, 0, 0, 0, 0]
=========================================================
- START: (6, 3), (6, 3)
- RIGHT: (6, 4), (6, 5)
- RIGHT: (3, 12), (9, 12)
- CUBE 1 DOWN: (4, 12), (9, 12)
- CUBE 1 DOWN: (5, 12), (9, 12)
- CUBE 1 DOWN: (6, 12), (9, 12)
- CUBE 1 DOWN: (7, 12), (9, 12)
- CUBE 2 UP: (7, 12), (8, 12)
- UP: (6, 12), (6, 12)
- RIGHT: (6, 13), (6, 14)
- RIGHT: (6, 15), (6, 15)
--> GOAL: (6, 15), (6, 15)
Time: 0.628 s
Memory: 32.3 MB