14 5 9
0 0 0 0 0 0 0 0 0 0 0 0 0 0 0 0 0 0 0
0 0 0 0 0 0 0 0 0 0 0 0 0 0 0 0 0 0 0
0 0 0 0 11 1 1 1 0 0 0 1 0 0 10 0 0 0 0
0 0 0 0 0 0 0 1 0 0 0 1 0 0 0 0 0 0 0
0 0 0 0 0 0 0 1 1 1 1 1 0 0 0 0 0 0 0
0 0 12 0 0 1 1 1 1 1 1 1 1 1 0 0 10 0 0
0 0 0 0 0 0 0 1 1 1 1 1 0 0 0 0 0 0 0
0 0 0 0 0 0 0 0 1 0 0 1 0 0 0 0 0 0 0
0 0 0 0 0 0 0 0 1 0 0 1 1 1 6 0 0 0 0
0 0 1 1 1 0 0 1 1 0 0 1 0 0 0 0 0 0 0
0 0 1 2 1 0 0 1 0 0 0 1 0 0 0 0 0 0 0
0 0 1 1 1 0 0 0 0 0 0 1 1 1 11 0 0 0 0
0 0 0 0 0 0 0 0 0 0 0 0 0 0 0 0 0 0 0
0 0 0 0 0 0 0 0 0 0 0 0 0 0 0 0 0 0 0
2 4 2 12 2 13 8 12 8 13
8 14 5 3 5 4
11 14 5 14 5 15 8 12 8 13 2 12 2 13 2 5 2 6
5 16 11 5 -1 -1
2 14 7 7 8 7
5 2 10 5 10 6 11 12 11 13