13 7 12
0 0 0 0 0 0 0 0 0 0 0 0 0 0 0 0 0 0
0 0 0 0 0 0 0 0 0 0 0 0 0 0 0 0 0 0
0 0 0 0 0 0 0 1 1 1 1 0 0 0 0 8 0 0
0 0 0 0 0 0 0 1 1 7 1 1 1 0 0 1 0 0
0 0 0 0 0 0 1 1 1 1 1 1 1 0 0 1 0 0
0 0 1 1 1 1 1 1 1 1 0 0 1 1 1 1 0 0
0 0 1 1 1 0 0 0 1 0 0 0 1 1 0 0 0 0
0 0 1 1 1 0 0 0 1 0 0 0 1 0 0 0 0 0
0 0 0 1 0 0 0 0 1 1 1 0 0 0 0 0 0 0
0 0 0 3 0 0 0 0 1 2 1 0 0 0 0 0 0 0
0 0 0 0 0 0 0 0 1 1 1 0 0 0 0 0 0 0
0 0 0 0 0 0 0 0 0 0 0 0 0 0 0 0 0 0
0 0 0 0 0 0 0 0 0 0 0 0 0 0 0 0 0 0
3 9 5 4 5 5
2 15 7 12 5 14
9 3 6 5 9 11