14 3 3
0 0 0 0 0 0 0 0 0 0 0 0 0 0 0 0 0 0 0
0 0 0 0 0 0 0 0 0 0 0 0 0 0 0 0 0 0 0
0 0 1 1 1 0 0 0 0 0 0 0 0 0 0 0 0 0 0
0 0 1 1 1 1 1 1 1 1 1 0 0 0 1 1 1 0 0
0 0 1 1 1 0 0 0 0 0 1 1 1 1 1 2 1 0 0
0 0 1 1 1 0 0 0 0 0 0 0 0 0 9 10 1 0 0
0 0 1 1 1 0 0 0 0 0 0 0 0 0 0 0 0 0 0
0 0 1 1 1 0 0 0 0 0 0 0 0 0 0 0 0 0 0
0 0 1 1 1 0 0 0 0 1 1 1 1 1 10 0 0 0 0
0 0 1 1 1 1 1 1 1 1 0 0 0 1 1 0 0 0 0
0 0 1 4 1 0 0 0 0 0 0 0 0 1 1 0 0 0 0
0 0 1 1 1 0 0 0 0 0 0 0 0 1 12 0 0 0 0
0 0 0 0 0 0 0 0 0 0 0 0 0 0 0 0 0 0 0
0 0 0 0 0 0 0 0 0 0 0 0 0 0 0 0 0 0 0
10 3 9 10 -1 -1
8 14 4 9 -1 -1
5 14 8 8 -1 -1
5 15 8 8 -1 -1
11 14 3 11 -1 -1 9 10 -1 -1