14 3 3
0 0 0 0 0 0 0 0 0 0 0 0 0 0 0 0 0 0 0
0 0 0 0 0 0 0 0 0 0 0 0 0 0 0 0 0 0 0
0 0 1 1 1 0 0 0 0 1 1 1 1 1 1 1 1 0 0
0 0 1 1 1 1 1 1 1 1 1 1 1 0 0 1 1 0 0
0 0 1 1 1 0 0 0 0 1 1 0 0 0 0 1 1 0 0
0 0 0 0 0 0 0 0 0 0 0 0 0 0 1 9 1 0 0
0 0 0 0 0 0 0 0 0 0 0 0 0 0 1 1 0 0 0
0 0 1 1 1 0 0 5 5 5 5 1 0 0 7 7 0 0 0
0 0 1 2 1 5 5 5 5 5 5 5 0 0 1 1 1 0 0
0 0 1 1 1 5 5 5 5 5 5 5 5 5 1 1 1 0 0
0 0 0 0 0 0 0 5 5 5 5 5 5 5 1 1 1 0 0
0 0 0 0 0 0 0 0 1 1 1 1 0 0 0 0 0 0 0
0 0 0 0 0 0 0 0 0 0 0 0 0 0 0 0 0 0 0
0 0 0 0 0 0 0 0 0 0 0 0 0 0 0 0 0 0 0
5 15 11 8 11 11
7 15 11 11 -1 -1
7 14 11 8 -1 -1