13 5 4
0 0 0 0 0 0 0 0 0 0 0 0 0 0 0 0 0 0 0
0 0 0 0 0 0 0 0 0 0 0 0 0 0 0 0 0 0 0
0 0 0 0 0 0 0 0 0 6 0 0 0 0 0 0 0 0 0
0 0 1 1 7 1 0 0 0 1 0 0 0 0 0 0 0 0 0
0 0 1 1 1 1 1 0 0 1 0 0 0 0 0 0 0 0 0
0 0 1 7 1 1 1 1 1 1 0 0 1 1 0 0 1 0 0
0 0 1 1 1 1 1 0 0 0 1 0 0 0 1 0 0 0 0
0 0 1 1 7 1 0 0 0 0 1 0 0 0 1 0 0 0 0
0 0 1 0 0 0 0 0 0 0 6 0 0 1 1 1 0 0 0
0 0 1 0 0 0 0 0 0 0 0 0 1 1 2 1 0 0 0
0 0 1 0 0 3 0 0 0 0 0 0 1 1 1 1 0 0 0
0 0 0 0 0 0 0 0 0 0 0 0 0 0 0 0 0 0 0
0 0 0 0 0 0 0 0 0 0 0 0 0 0 0 0 0 0 0
2 9 5 10 5 11
5 3 5 10 5 11
3 4 5 14 5 15 10 3 10 4
7 4 5 14 5 15 10 3 10 4
8 10 5 14 5 15 10 3 10 4
10 5 6 7 -1 -1