14 8 4
0 0 0 0 0 0 0 0 0 0 0 0 0 0 0 0 0
0 0 0 0 0 0 0 0 0 0 0 0 0 0 0 0 0
0 0 0 0 0 0 0 0 0 0 0 0 0 0 3 0 0
0 0 0 0 0 0 0 1 1 1 0 0 1 1 1 0 0
0 0 0 0 0 0 0 1 3 1 1 1 1 1 0 0 0
0 0 0 0 0 1 1 1 1 1 0 0 1 1 0 0 0
0 0 0 0 0 1 2 1 0 0 0 0 1 1 0 0 0
0 0 0 1 1 1 1 1 0 0 0 1 1 1 1 0 0
0 0 1 1 1 1 0 0 0 0 0 1 1 1 1 0 0
0 0 1 1 1 1 0 0 1 1 1 1 1 0 0 0 0
0 0 0 0 0 0 0 1 1 1 0 0 0 0 0 0 0
0 0 0 0 0 0 0 1 1 1 0 0 0 0 0 0 0
0 0 0 0 0 0 0 0 0 0 0 0 0 0 0 0 0
0 0 0 0 0 0 0 0 0 0 0 0 0 0 0 0 0
4 8 4 14 -1 -1
2 14 6 8 -1 -1