13 8 12
0 0 0 0 0 0 0 0 0 0 0 0 0 0 0 0 0 0
0 0 0 0 0 0 0 0 0 0 0 0 0 0 0 0 0 0
0 0 0 0 0 0 0 0 0 0 0 0 0 0 1 3 0 0
0 0 0 0 1 1 1 1 1 1 0 0 0 1 1 1 0 0
0 0 0 1 1 1 0 0 1 1 0 0 1 3 1 1 0 0
0 0 0 1 2 1 0 0 0 1 1 1 1 1 0 0 0 0
0 0 0 1 1 1 0 0 0 0 1 1 1 0 0 0 0 0
0 0 0 0 0 0 0 0 0 0 0 1 1 0 0 0 0 0
0 0 0 0 0 0 1 1 1 0 0 1 1 0 0 0 0 0
0 0 1 1 0 0 1 3 1 0 0 1 1 0 0 0 0 0
0 0 1 1 0 0 1 1 1 1 1 1 1 0 0 0 0 0
0 0 0 0 0 0 0 0 0 0 0 0 0 0 0 0 0 0
0 0 0 0 0 0 0 0 0 0 0 0 0 0 0 0 0 0
4 13 10 4 10 5
2 15 9 4 9 5 3 6 3 7
9 7 4 6 4 7