14 9 3
0 0 0 0 0 0 0 0 0 0 0 0 0 0 0 0 0 0
0 0 0 0 0 0 0 0 0 0 0 0 0 0 0 0 0 0
0 0 0 0 1 1 0 0 0 0 0 0 0 0 0 0 0 0
0 0 0 0 1 1 1 0 0 0 0 0 0 0 0 0 0 0
0 0 0 0 1 1 4 0 0 0 0 0 1 1 1 0 0 0
0 0 0 0 0 1 1 1 1 0 0 0 1 2 1 0 0 0
0 0 0 0 0 0 0 0 1 1 0 0 1 1 1 0 0 0
0 0 0 1 1 0 0 0 1 1 0 0 0 0 0 0 0 0
0 0 1 1 10 1 1 1 1 1 0 0 0 0 0 0 0 0
0 0 1 1 1 0 0 0 1 1 0 0 0 1 1 1 0 0
0 0 1 1 1 0 0 0 1 1 11 1 1 1 1 1 0 0
0 0 0 0 0 0 0 0 0 0 0 0 0 1 1 1 0 0
0 0 0 0 0 0 0 0 0 0 0 0 0 0 0 0 0 0
0 0 0 0 0 0 0 0 0 0 0 0 0 0 0 0 0 0
8 4 6 10 6 11
10 10 5 9 -1 -1 8 6 8 7
4 6 6 10 6 11 4 15 5 15