14 4 10
0 0 0 0 0 0 0 0 0 0 0 0 0 0 0 0 0 0 0
0 0 0 0 0 0 0 0 0 0 0 0 0 0 0 0 0 0 0
0 0 0 0 0 0 0 0 0 0 0 0 0 0 1 1 1 0 0
0 0 0 0 1 1 1 1 1 1 1 1 0 0 1 1 1 0 0
0 0 0 0 1 1 1 0 0 7 1 1 0 0 1 1 1 0 0
0 0 0 0 1 1 1 0 0 1 1 1 0 0 0 0 0 0 0
0 0 0 0 1 7 1 0 0 8 1 7 0 0 0 0 0 0 0
0 0 0 0 1 1 1 0 0 1 1 1 0 0 0 0 0 0 0
0 0 1 1 1 1 0 0 0 1 1 1 0 0 4 1 1 0 0
0 0 1 4 0 0 0 0 0 0 0 0 0 0 1 1 1 0 0
0 0 0 0 0 0 0 0 0 0 0 0 0 0 1 2 1 0 0
0 0 0 0 0 0 0 0 0 0 0 0 0 0 1 1 1 0 0
0 0 0 0 0 0 0 0 0 0 0 0 0 0 0 0 0 0 0
0 0 0 0 0 0 0 0 0 0 0 0 0 0 0 0 0 0 0
6 11 3 7 3 8
4 9 3 7 3 8
6 9 3 15 9 15
8 14 8 12 8 13
6 5 3 7 3 8
9 3 3 12 3 13