14 7 2
0 0 0 0 0 0 0 0 0 0 0 0 0 0 0 0
0 0 0 0 0 0 0 0 0 0 0 0 0 0 0 0
0 0 0 1 1 1 1 0 0 0 0 0 0 0 0 0
0 0 0 1 2 1 1 0 0 0 0 0 0 0 0 0
0 0 0 1 1 1 0 0 0 0 0 0 0 0 0 0
0 0 0 1 0 0 0 1 1 1 1 1 1 0 0 0
0 0 0 1 0 0 0 1 1 0 0 1 1 0 0 0
0 0 1 1 1 1 1 1 1 0 0 1 1 1 0 0
0 0 0 0 0 0 0 1 7 0 0 0 0 1 0 0
0 0 0 0 0 0 0 1 1 1 1 0 0 1 0 0
0 0 0 0 0 0 0 1 1 1 1 1 1 1 0 0
0 0 0 0 0 0 0 0 0 0 1 1 1 0 0 0
0 0 0 0 0 0 0 0 0 0 0 0 0 0 0 0
0 0 0 0 0 0 0 0 0 0 0 0 0 0 0 0
8 8 2 6 3 6