14 9 14
0 0 0 0 0 0 0 0 0 0 0 0 0 0 0 0 0 0 0
0 0 0 0 0 0 0 0 0 0 0 0 0 0 0 0 0 0 0
0 0 0 0 0 0 0 0 0 0 0 0 0 1 1 1 0 0 0
0 0 0 1 1 1 0 0 0 0 3 0 0 1 2 1 0 0 0
0 0 0 1 1 1 1 1 1 1 1 0 0 1 1 1 0 0 0
0 0 0 1 1 1 0 0 1 1 1 0 0 0 1 0 0 0 0
0 0 0 5 5 5 0 0 7 1 1 0 0 0 5 0 0 0 0
0 0 0 0 5 0 0 0 1 1 1 0 0 5 5 5 0 0 0
0 0 0 0 1 0 0 0 1 1 1 0 0 1 1 1 0 0 0
0 0 1 1 1 1 0 0 1 7 1 1 1 1 1 1 0 0 0
0 0 1 1 12 1 0 0 3 0 0 0 0 1 1 1 0 0 0
0 0 1 1 1 1 0 0 0 0 0 0 0 0 0 0 0 0 0
0 0 0 0 0 0 0 0 0 0 0 0 0 0 0 0 0 0 0
0 0 0 0 0 0 0 0 0 0 0 0 0 0 0 0 0 0 0
9 9 4 6 4 7 4 11 4 12 9 6 9 7 9 11 9 12
6 8 4 6 4 7 4 11 4 12 9 6 9 7 9 11 9 12
10 4 2 16 3 16 4 16 4 6 4 7 -2
10 8 9 6 9 7
3 10 4 11 4 12