14 9 6
0 0 0 0 0 0 0 0 0 0 0 0 0 0 0 0 0 0 0
0 0 0 0 0 0 0 0 0 0 0 0 0 0 0 0 0 0 0
0 0 0 1 1 1 0 0 0 0 0 0 0 0 1 1 1 0 0
0 0 0 1 10 1 0 0 0 0 0 0 0 0 1 6 1 0 0
0 0 0 1 1 1 0 0 0 1 1 1 1 1 1 1 1 0 0
0 0 0 1 1 1 0 0 0 1 2 1 0 0 1 1 7 0 0
0 0 1 0 0 0 1 0 0 1 1 1 0 0 0 0 1 0 0
0 0 11 0 0 0 1 0 0 5 5 5 0 0 0 0 1 0 0
0 0 1 0 0 1 1 1 5 5 5 5 5 1 1 1 1 0 0
0 0 0 0 0 1 1 1 5 5 5 5 5 1 8 1 0 0 0
0 0 0 0 0 1 1 1 5 5 5 5 5 1 1 1 0 0 0
0 0 0 0 0 1 1 1 1 1 0 0 0 0 0 0 0 0 0
0 0 0 0 0 0 0 0 0 0 0 0 0 0 0 0 0 0 0
0 0 0 0 0 0 0 0 0 0 0 0 0 0 0 0 0 0 0
5 16 4 12 4 13
3 15 8 3 8 4 11 10 -1 -1
9 14 4 4 9 14
7 2 5 2 -1 -1 8 3 8 4
3 4 5 6 -1 -1