14 6 4
0 0 0 0 0 0 0 0 0 0 0 0 0 0 0 0 0 0 0
0 0 0 0 0 0 0 0 0 0 0 0 0 0 0 0 0 0 0
0 0 0 0 0 1 1 1 1 1 5 5 1 1 1 1 0 0 0
0 0 0 0 0 1 2 1 1 0 0 0 0 0 5 1 0 0 0
0 0 0 0 0 1 1 1 0 0 0 0 0 0 5 1 12 0 0
0 0 0 0 0 0 0 0 0 5 1 1 1 1 1 1 1 0 0
0 0 0 0 1 0 0 0 0 5 5 0 0 0 0 0 1 0 0
0 0 0 10 1 5 0 0 0 5 5 0 0 0 0 0 1 0 0
0 0 5 5 5 5 0 0 0 1 1 0 0 0 0 1 1 0 0
0 0 5 5 5 1 5 1 5 5 1 5 0 0 3 1 0 0 0
0 0 1 5 5 5 5 5 5 5 5 5 5 5 1 0 0 0 0
0 0 0 5 1 5 5 5 0 0 5 5 5 5 1 0 0 0 0
0 0 0 0 0 0 0 0 0 0 0 0 0 0 0 0 0 0 0
0 0 0 0 0 0 0 0 0 0 0 0 0 0 0 0 0 0 0
7 3 5 12 5 13
9 14 9 16 -1 -1
4 16 8 11 8 14 5 12 5 13