14 4 4 
0 0 0 0 0 0 0 0 0 0 0 0 0 0 0 0 0 0 0
0 0 0 0 0 0 0 0 0 0 0 0 0 0 0 0 0 0 0
0 0 0 1 1 1 1 1 1 0 0 0 0 0 0 0 0 0 0
0 0 0 1 1 0 0 1 1 1 0 0 0 0 0 0 0 0 0
0 0 5 5 1 0 0 1 1 1 1 0 0 0 0 0 0 0 0
0 0 5 5 0 0 0 0 0 1 1 1 0 0 0 0 0 0 0
0 0 5 5 0 0 0 0 0 0 1 1 1 0 0 0 0 0 0
0 0 5 1 1 1 0 0 0 0 0 1 1 8 0 0 0 0 0
0 0 0 1 2 1 0 0 0 0 0 0 1 1 1 1 1 0 0
0 0 0 1 1 1 1 1 1 0 0 0 1 7 1 1 1 0 0
0 0 0 0 1 0 0 1 1 0 0 0 1 1 1 0 0 0 0
0 0 0 0 1 0 0 1 1 1 1 1 1 1 1 0 0 0 0
0 0 0 0 0 0 0 0 0 0 0 0 0 0 0 0 0 0 0
0 0 0 0 0 0 0 0 0 0 0 0 0 0 0 0 0 0 0
9 13 11 10 11 11 2 5 2 6
7 13 11 14 8 16