12 4 3
0 0 0 0 0 0 0 0 0 0 0 0 0 0 0 0 0 0
0 0 0 0 0 0 0 0 0 0 0 0 0 0 0 0 0 0
0 0 0 0 0 0 0 0 0 0 0 0 1 1 1 1 0 0
0 0 0 0 0 0 1 1 1 1 1 1 1 10 1 8 0 0
0 0 0 1 0 0 1 10 1 0 0 0 1 1 1 1 0 0
0 0 10 1 0 0 1 1 0 0 0 0 0 0 1 0 0 0
0 0 1 1 0 0 1 0 0 0 0 0 0 0 1 0 0 0
0 0 1 1 1 1 1 0 0 0 0 0 1 1 1 0 0 0
0 0 1 1 1 0 0 1 1 1 0 0 1 2 1 0 0 0
0 0 0 0 0 0 0 10 1 0 0 0 1 1 1 0 0 0
0 0 0 0 0 0 0 0 0 0 0 0 0 0 0 0 0 0
0 0 0 0 0 0 0 0 0 0 0 0 0 0 0 0 0 0
5 2 3 5 -1 -1
3 13 4 4 4 5
4 7 9 9 -1 -1
9 7 8 10 8 11
3 15 8 7 8 9