x x x
0 0 0 0 0 0 0 0 0 0 0 0 0 0 0 0 0 0 0
0 0 0 0 0 0 0 0 0 0 0 0 0 0 0 0 0 0 0
0 0 0 0 0 0 0 0 0 1 1 1 0 0 1 1 1 0 0
0 0 0 0 0 0 1 1 1 1 1 1 0 0 3 1 1 0 0
0 0 1 1 0 0 1 0 0 1 1 1 0 0 1 1 1 0 0
0 0 1 1 1 1 1 0 0 0 x 0 0 0 0 0 0 0 0
0 0 1 1 0 0 0 0 0 0 0 0 0 0 0 0 0 0 0
0 0 0 1 0 0 0 0 0 8 0 0 0 0 0 0 0 0 0
0 0 0 1 0 0 0 0 0 1 0 0 0 0 0 0 0 0 0
0 0 1 1 1 0 0 0 1 1 1 0 0 x 1 1 0 0 0
0 0 1 1 1 1 1 1 1 1 1 1 1 1 2 1 0 0 0
0 0 1 1 1 0 0 0 1 1 1 0 0 x 1 1 0 0 0
0 0 0 0 0 0 0 0 0 0 0 0 0 0 0 0 0 0 0
0 0 0 0 0 0 0 0 0 0 0 0 0 0 0 0 0 0 0