12 8 5
0 0 0 0 0 0 0 0 0 0 0 0 0 0 0 0 0
0 0 0 0 0 0 0 0 0 0 0 0 0 0 0 0 0
0 0 0 8 0 0 0 0 0 0 0 0 1 1 1 0 0
0 0 8 1 8 0 0 3 3 1 0 0 1 2 1 0 0
0 0 0 8 0 0 0 0 0 0 0 0 1 1 1 0 0
0 0 0 0 0 0 0 0 0 0 0 0 0 0 0 0 0
0 0 0 0 0 0 0 0 0 0 0 0 0 0 0 0 0
0 0 0 0 1 1 1 0 0 0 1 1 1 0 0 0 0
0 0 0 0 1 1 1 1 1 1 1 8 1 0 0 0 0
0 0 0 0 1 1 1 0 0 0 1 1 1 0 0 0 0
0 0 0 0 0 0 0 0 0 0 0 0 0 0 0 0 0
0 0 0 0 0 0 0 0 0 0 0 0 0 0 0 0 0
8 11 3 2 2 3
3 4 3 2 3 4
3 2 2 3 3 4
4 3 3 2 4 3
2 3 3 7 3 9
3 7 3 5 3 6
3 8 3 10 3 11