14 3 15
0 0 0 0 0 0 0 0 0 0 0 0 0 0 0 0 0 0 0
0 0 0 0 0 0 0 0 0 0 0 0 0 0 0 0 0 0 0
0 0 0 0 0 0 0 0 0 0 0 0 0 1 1 1 1 0 0
0 0 0 1 1 1 1 1 1 1 4 1 1 1 1 1 1 0 0
0 0 0 1 1 1 1 0 0 0 0 0 0 0 1 1 1 0 0
0 0 0 1 1 6 1 0 0 0 0 0 0 0 0 0 0 0 0
0 0 0 1 1 1 1 0 0 0 0 0 0 0 0 0 0 0 0
0 0 0 0 0 1 1 1 7 1 1 1 1 1 1 0 0 0 0
0 0 0 0 0 0 0 0 0 0 0 0 1 1 1 1 4 0 0
0 0 1 1 1 0 0 0 0 0 0 0 1 1 1 1 1 0 0
0 0 1 2 1 1 1 1 1 1 1 1 1 1 1 0 0 0 0
0 0 1 1 1 1 0 0 0 0 0 0 0 0 0 0 0 0 0
0 0 0 0 0 0 0 0 0 0 0 0 0 0 0 0 0 0 0
0 0 0 0 0 0 0 0 0 0 0 0 0 0 0 0 0 0 0
3 10 3 7 3 8
5 5 10 7 10 8
7 8 10 7 10 8
8 16 10 7 10 8