14 10 3
0 0 0 0 0 0 0 0 0 0 0 0 0 0 0 0 0 0 0
0 0 0 0 0 0 0 0 0 0 0 0 0 0 0 0 0 0 0
0 0 0 0 0 0 0 0 0 1 1 1 0 0 1 1 1 0 0
0 0 0 0 0 0 1 1 1 1 1 1 0 0 3 1 1 0 0
0 0 1 1 0 0 1 0 0 1 1 1 0 0 1 1 1 0 0
0 0 1 1 1 1 1 0 0 0 4 0 0 0 0 0 0 0 0
0 0 1 1 0 0 0 0 0 0 0 0 0 0 0 0 0 0 0
0 0 0 1 0 0 0 0 0 8 0 0 0 0 0 0 0 0 0
0 0 0 1 0 0 0 0 0 1 0 0 0 0 0 0 0 0 0
0 0 1 1 1 0 0 0 1 1 1 0 0 7 1 1 0 0 0
0 0 1 1 1 1 1 1 1 1 1 1 1 1 2 1 0 0 0
0 0 1 1 1 0 0 0 1 1 1 0 0 7 1 1 0 0 0
0 0 0 0 0 0 0 0 0 0 0 0 0 0 0 0 0 0 0
0 0 0 0 0 0 0 0 0 0 0 0 0 0 0 0 0 0 0
7 9 10 3 3 15
5 10 3 7 3 8 3 12 3 13
3 14 3 7 3 8 4 4 4 5
9 13 10 11 10 12
11 13 10 11 10 12