14 4 6
0 0 0 0 0 0 0 0 0 0 0 0 0 0 0 0 0 0
0 0 0 0 0 0 0 0 0 0 0 0 0 0 0 0 0 0
0 0 0 0 0 0 0 0 0 0 1 1 1 0 0 0 0 0
0 0 0 0 0 1 1 1 0 0 1 1 1 0 0 0 0 0
0 0 1 0 0 1 1 1 1 1 1 1 1 1 1 1 0 0
0 0 1 0 0 1 1 1 0 0 0 0 0 0 3 1 0 0
0 0 1 0 0 0 0 0 0 0 0 0 0 0 1 1 0 0
0 0 1 0 0 0 0 0 0 0 0 0 0 0 1 1 0 0
0 0 1 0 0 0 0 0 0 0 1 1 1 1 1 1 0 0
0 0 1 1 1 1 1 0 0 0 1 1 1 0 0 0 0 0
0 0 0 1 1 2 1 0 0 0 1 1 1 0 0 0 0 0
0 0 0 0 1 1 1 0 0 0 1 1 1 1 1 3 0 0
0 0 0 0 0 0 0 0 0 0 0 0 0 0 0 0 0 0
0 0 0 0 0 0 0 0 0 0 0 0 0 0 0 0 0 0
5 14 4 3 4 4
11 15 5 3 5 4