12 5 3
0 0 0 0 0 0 0 0 0 0 0 0 0 0 0 0 0 0 0
0 0 0 0 0 0 0 0 0 0 0 0 0 0 0 0 0 0 0
0 0 0 0 0 0 0 0 0 0 1 1 1 1 0 0 0 0 0
0 0 0 0 0 0 0 0 0 0 1 1 1 1 0 0 0 0 0
0 0 1 1 1 0 0 0 0 0 1 0 0 1 1 1 1 0 0
0 0 1 1 1 1 1 1 1 1 1 0 0 0 1 2 1 0 0
0 0 1 1 1 0 0 0 0 1 1 3 0 0 1 1 1 0 0
0 0 1 1 1 0 0 0 0 1 1 1 0 0 1 1 1 0 0
0 0 0 1 1 0 0 0 0 1 0 0 0 0 0 0 0 0 0
0 0 0 0 1 1 1 1 1 1 0 0 0 0 0 0 0 0 0
0 0 0 0 0 0 0 0 0 0 0 0 0 0 0 0 0 0 0
0 0 0 0 0 0 0 0 0 0 0 0 0 0 0 0 0 0 0
6 11 8 5 -1 -1
