14 5 3
0 0 0 0 0 0 0 0 0 0 0 0 0 0 0 0 0 0 0
0 0 0 0 0 0 0 0 0 0 0 0 0 0 0 0 0 0 0
0 0 0 0 0 0 0 0 0 0 1 1 0 0 0 0 0 0 0
0 0 0 0 0 0 0 0 0 1 1 1 0 0 0 0 0 0 0
0 0 1 1 0 0 1 1 1 1 1 1 0 0 0 0 0 0 0
0 0 1 1 1 1 1 1 0 0 1 0 0 0 0 0 0 0 0
0 0 1 1 1 1 0 0 0 0 1 0 0 0 1 1 1 0 0
0 0 0 1 1 0 0 0 0 0 3 1 1 1 1 2 1 0 0
0 0 0 0 1 0 0 0 0 0 3 1 0 0 1 1 1 0 0
0 0 0 0 1 1 1 0 0 0 1 1 0 0 0 0 0 0 0
0 0 0 0 0 1 1 1 0 0 1 1 0 0 0 0 0 0 0
0 0 0 0 0 0 1 1 1 1 1 1 0 0 0 0 0 0 0
0 0 0 0 0 0 0 0 0 0 0 0 0 0 0 0 0 0 0
0 0 0 0 0 0 0 0 0 0 0 0 0 0 0 0 0 0 0
7 10 11 5 -1 -1
8 10 9 7 -1 -1