10 6 3
0 0 0 0 0 0 0 0 0 0 0 0 0 0 0 0 0 0 0
0 0 0 0 0 0 0 0 0 0 0 0 0 0 0 0 0 0 0
0 0 0 0 0 0 0 0 1 1 1 1 0 0 1 1 1 0 0
0 0 1 1 1 1 0 0 1 1 3 1 0 0 1 2 1 0 0
0 0 1 1 4 1 0 0 1 1 1 1 0 0 1 1 1 0 0
0 0 1 1 1 1 0 0 1 1 1 1 0 0 1 1 1 0 0
0 0 1 1 1 1 0 0 1 1 1 1 0 0 1 1 1 0 0
0 0 1 1 1 1 0 0 1 1 1 1 0 0 0 0 0 0 0
0 0 0 0 0 0 0 0 0 0 0 0 0 0 0 0 0 0 0
0 0 0 0 0 0 0 0 0 0 0 0 0 0 0 0 0 0 0
4 4 6 6 6 7
3 10 6 12 6 13
