14 5 3
0 0 0 0 0 0 0 0 0 0 0 0 0 0 0 0 0 0
0 0 0 0 0 0 0 0 0 0 0 0 0 0 0 0 0 0
0 0 0 0 0 0 0 1 1 0 0 0 0 1 1 1 0 0
0 0 0 0 0 1 1 1 1 1 1 0 0 1 2 1 0 0
0 0 1 1 1 1 1 1 7 1 1 1 1 1 1 1 0 0
0 0 1 1 1 1 7 0 0 1 1 1 1 1 0 0 0 0
0 0 1 1 1 0 0 0 0 0 0 1 1 1 0 0 0 0
0 0 0 1 0 0 0 0 0 0 0 0 1 0 0 0 0 0
0 0 0 1 0 0 0 0 0 0 0 0 1 0 0 0 0 0
0 0 0 1 0 0 0 0 0 0 0 1 1 0 0 0 0 0
0 0 0 1 1 0 0 0 0 0 0 1 1 0 0 0 0 0
0 0 0 0 3 0 0 0 0 0 0 3 0 0 0 0 0 0
0 0 0 0 0 0 0 0 0 0 0 0 0 0 0 0 0 0
0 0 0 0 0 0 0 0 0 0 0 0 0 0 0 0 0 0
5 6 9 4 5 14
4 8 9 4 5 14
11 11 9 4 -1 -1
11 4 5 14 -1 -1