13 5 2
0 0 0 0 0 0 0 0 0 0 0 0 0 0 0 0 0
0 0 0 0 0 0 0 0 0 0 0 0 0 0 0 0 0
0 0 0 0 0 0 0 6 0 0 0 0 0 0 0 0 0
1 1 7 1 0 0 0 1 0 0 0 0 0 0 0 0 0
1 1 1 1 1 0 0 1 0 0 0 0 0 0 0 0 0
1 7 1 1 1 1 1 1 0 0 1 1 0 0 1 0 0
1 1 1 1 1 0 0 0 1 0 0 0 1 0 0 0 0
1 1 7 1 0 0 0 0 1 0 0 0 1 0 0 0 0
1 0 0 0 0 0 0 0 6 0 0 1 1 1 0 0 0
1 0 0 0 0 0 0 0 0 0 1 1 2 1 0 0 0
1 0 0 3 0 0 0 0 0 0 1 1 1 1 0 0 0
0 0 0 0 0 0 0 0 0 0 0 0 0 0 0 0 0
0 0 0 0 0 0 0 0 0 0 0 0 0 0 0 0 0
2 7 5 8 5 9
5 1 5 8 5 9
3 2 5 12 5 13 10 1 10 2
7 2 5 12 5 13 10 1 10 2
8 8 5 12 5 13 10 1 10 2
10 3 7 4 -1 -1